,.,.,.,.,.,.,.,.,.,.,.,.,.,.,.,.,.,.,.,. 
........................................
........................................
........................................
........................................
........................................
........................................
................,,,,,,,,,,,,,,,,,,......
................,,,,,,,,,,,,,,,,,,...,..
................,,,,,,,,,,,,,,,,,,......
................,,,,,,,,,,,,,,,,,,..,,,.
................,,,,,,,,,,,,,,,,,,......
................,,,,,,,,,,,,,,,,,,......
................,,,,,,,,,,,,,,,,,,...,..
.....................................,..
.....................................,..
.....................................,..
........................................
........................................
........................................
........................................
........................................
........................................
........................................
........................................
........................................
........................................
........................................
........................................
,.,.,.,.,.,.,.,.,.,.,.,.,.,.,.,.,.,.,.,. 