,.,.,.,.,.,.,.,.,.,.,.,.,.,.,.,.,.,.,.,. 
........................................
........................................
........................................
........................................
................,,..,,,...,,,.,,,.......
................,,,,,,,,,,,,,,,,,,......
................,,,,,,,,,,,,,,,,,,......
................,,,,,.,,,,,,,,,,,,,..,..
...............,,,,,....,,,,,,,,,,,.....
...............,,,,,.....,,,,,,,,,,.,,,.
...............,,,,,...,,,,,,,,,,,......
................,,,,,,,,,,,,,,,,,,......
................,,,,,,,,,,,,,,,,,....,..
...................,,,,,.............,..
.....................,...............,..
.....................................,..
........................................
........................................
..............,.........................
.............,,,........................
............,,,,,.......................
.............,,,........................
..............,.........................
........................................
........................................
........................................
........................................
........................................
,.,.,.,.,.,.,.,.,.,.,.,.,.,.,.,.,.,.,.,. 